R 640 480
NO ./textures/eagle.xpm
SO ./textures/greystone.xpm
WE ./textures/redbrick.xpm
EA ./textures/purplestone.xpm

S ./textures/barrel.xpm
F 220,100,0
C 225,30,0

111111111111
122222222221
12222N222221
122222222221
111111111111